1111111111
1000001001
100001E101
100C001001
1000000001
100P000001
1000000001
1111111111
