1111111111
1E00000001
1000000011
10000001C1
1000000011
100P000001
1111111111
