11111111111111111111
10000000000000000001
10000000000000000001
100000000000P0000001
10000000000000000001
10000000000000000001
10000000000000000001
100000000000E0000001
100000C0000000000001
10000000000000000001
10000000000000000001
11111101111111111111
