000000000000
000000001000
000000000000
00000PCE0000
000100000000
000000000000
