1111111111
1000000001
1000000001
100P000P01
1000000001
1000000E01
100C000001
1111111111
