11111111111
1001E100001
10001000001
10000000E01
10000000001
100PC000001
11111111111
