asdpjfnojfnqweofasdknvwl;kfqerpo234ht09q8rehfpoq2nrfoieqjwbfn1o24uigfdausfhapoeqjb
	2


12r
123r

3r1p2rh132ry0928  po1i23h98132hr
1
3

1
23
423948u-0132 434 
1


1111111111111111111111111111111111111111111
1000001010000000000000000000000000000000001
1000001P10000000000000000000000000000000001
1000001C10000000000000000000000000000000001
1000001E10000000000000000000000000000000001
1000001010000000000000000000000000000000001
1000001010000000000000000000000000000000001
1000001010000000000000000000000000000000001
1000001010000000000000000000000000000000001
1000001010000000000000000000000000000000001
1000000010000000000000000000000000000000001
1000000010000000000000000000000000000000001
1000000000000000000000000000000000000000001
1111111111111111111111111111111111111111111



124123

123
41
123
4
1



sfd;lkmd;lm;S,M[POIJ1243
4
123
41
32412OP3I4U1-23948-10234KP1 324
3124
3124

1234
123
41
324[13P249I-0132948M-02139U4M-019401J40I123U409IJ4
134

234
2134K1320479123094PO32I4J324123432
42
134[213U40392U4PO2M34L32M4;K32J4P023U4MP23U409123MU41234

123J4P1324]]]