11111111111111111111
10000010000001000001
10000010000101000001
1000001000010100C001
10000010000101000001
10000010000101000001
100C0010000101000001
10000010000101000001
10000010000101000001
1000C010000101000001
10000010P00101000001
10000000000100000001
11111111111111111001
10000000000000000001
10000000000000000001
11111100000000000001
100010C0000001111101
10001000000001E11111
10001000000000C00001
11111111111111111111