11111111111111111111
1CCCCCCCCCCCC1CCCCC1
1CCCCCCCCCC1C1CCCCC1
1CCCCCCCCCC1C1CCCCC1
1CCCCCCCCCC1C1CCCCC1
1CCCCCCCCCC1C1CCCCC1
1CCCCCCCCCC1C1CCCCC1
1CCCCCCCCCC1C1CCCCC1
1CCCCCCCCCC1C1CCCCC1
1CCCCCCCCCC1C1CCCCC1
1CCCCCCCPCC1C1CCCCC1
1CCCCCCCCCC1CCCCCCC1
11111111111111111CC1
1CCCCCCCCCCCCCCCCCC1
1CCCCCCCCCCCCCCCCCC1
111111CCCCCCCCCCCCC1
10001CCCCCCCC11111C1
10001CCCCCCCC1E11111
10001CCCCCCCC00CCCC1
11111111111111111111