11111111111111111111
10000000000001000001
10000000000101000001
1000000000010100C001
10000000000101000001
10000000000101000001
10000000000101000001
10000000000101000001
10000000000101000001
10000000000101000001
10000000P00101000001
10000000000100000001
11111111111111111001
10000000000000000001
10000000000000000001
11111100000000000001
10001000000001111101
10001000000001E11111
10001000000000C00001
11111111111111111111