1111111111111111111111111111111111111111111111111111111111111
10000000000000000000000000000000C10000000000000000000000000E1
1001111111111111111111111111111111001111111111111111111111111
10000000000000000000000000000000000000000000000000C0000000001
1001111111111111111111111111111111111111111111111111111111111
10000000000000000000000000000000000000000000000000000000000P1
1111111111111111111111111111111111111111111111111111111111111
