1111111111
1000000001
1000000001
1000000001
1000E00001
1111111011
1000P00001
1111111101
100000C001
1111111111