1111111
100P001
1011111
1011111
1011111
1011111
1011111
1011111
1011111
1011111
1011111
1011111
1011111
1011111
1011111
1011111
1011111
1000001
1010001
1010001
1010001
1010001
10100C1
1011111
1000001
1010001
101C001
1010001
1010001
101E111
1000001
1000001
1111111
